"aa" = (/turf/unsimulated/floor/snow,/area/lornfront/sector5)
"ab" = (/turf/unsimulated/floor/snow,/area/lornfront/sector4)
"ac" = (/turf/unsimulated/floor/snow,/area/lornfront/sector3)
"ad" = (/turf/unsimulated/floor/snow,/area/lornfront/sector2)
"ae" = (/turf/unsimulated/floor/snow,/area/lornfront/sector1)
"af" = (/obj/structure/barricade/metal,/turf/unsimulated/floor/snow,/area/lornfront/sector1)
"ag" = (/obj/structure/barricade/metal,/turf/simulated/floor,/area/lornfront/bunker)
"ah" = (/turf/simulated/floor/plating/snowy,/area/lornfront/sector1)
"ai" = (/turf/simulated/wall,/area/lornfront/bunker)
"aj" = (/turf/simulated/floor,/area/lornfront/bunker)
"ak" = (/obj/machinery/door/airlock{name = "Frontier Bunker"},/turf/simulated/floor,/area/lornfront/bunker)
"al" = (/turf/simulated/wall,/area/lornfront/bunker/guardsmen)
"am" = (/obj/item/weapon/twohanded/required/laserc,/turf/simulated/floor,/area/lornfront/bunker/guardsmen)
"an" = (/turf/simulated/floor,/area/lornfront/bunker/guardsmen)
"ao" = (/obj/machinery/rack/lasgun/full,/turf/simulated/floor,/area/lornfront/bunker/guardsmen)
"ap" = (/obj/machinery/rack/firstaid/full,/turf/simulated/floor,/area/lornfront/bunker/guardsmen)
"aq" = (/obj/machinery/rack/frags/full,/turf/simulated/floor,/area/lornfront/bunker/guardsmen)
"ar" = (/obj/structure/rack,/obj/item/ammo_box/magazine/laspistolmag,/obj/item/ammo_box/magazine/laspistolmag,/turf/simulated/floor,/area/lornfront/bunker/guardsmen)
"as" = (/obj/machinery/door/airlock{name = "Armory"},/turf/simulated/floor,/area/lornfront/bunker/guardsmen)
"at" = (/obj/machinery/rack/kraks/full,/turf/simulated/floor,/area/lornfront/bunker/guardsmen)
"au" = (/obj/machinery/rack/ration/full,/turf/simulated/floor,/area/lornfront/bunker/guardsmen)
"av" = (/obj/machinery/rack/firstaid2/full,/turf/simulated/floor,/area/lornfront/bunker/guardsmen)
"aw" = (/obj/machinery/rack/longlas/full,/turf/simulated/floor,/area/lornfront/bunker/guardsmen)
"ax" = (/obj/machinery/rack/combatknife/full,/turf/simulated/floor,/area/lornfront/bunker/guardsmen)
"ay" = (/obj/structure/rack,/obj/item/ammo_box/magazine/lasgunmag,/obj/item/ammo_box/magazine/lasgunmag,/obj/item/ammo_box/magazine/lasgunmag,/obj/item/ammo_box/magazine/lasgunmag,/obj/item/ammo_box/magazine/lasgunmag,/turf/simulated/floor,/area/lornfront/bunker/guardsmen)
"az" = (/turf/simulated/wall/polar2,/area/lornfront/bunker/command)
"aA" = (/obj/structure/filingcabinet,/obj/effect/decal/cleanable/dirt,/turf/simulated/floor{dir = 2; icon_state = "floor"; tag = "icon-warningcorner"},/area/lornfront/bunker/command)
"aB" = (/obj/structure/filingcabinet,/turf/simulated/floor{dir = 2; icon_state = "floor"; tag = "icon-warningcorner"},/area/lornfront/bunker/command)
"aC" = (/obj/machinery/light{dir = 1; luminosity = 2},/turf/simulated/floor{dir = 2; icon_state = "floor"; tag = "icon-warningcorner"},/area/lornfront/bunker/command)
"aD" = (/turf/simulated/floor{dir = 2; icon_state = "floor"; tag = "icon-warningcorner"},/area/lornfront/bunker/command)
"aE" = (/obj/structure/table/reinforced,/obj/item/weapon/lighter/zippo,/obj/effect/decal/cleanable/cobweb2,/turf/simulated/floor{dir = 2; icon_state = "floor"; tag = "icon-warningcorner"},/area/lornfront/bunker/command)
"aF" = (/obj/structure/closet{desc = "Where you keep your heretical findings and then be charged for heresy."; icon_closed = "cabinet_closed"; icon_opened = "cabinet_open"; icon_state = "cabinet_closed"; name = "General's closet"},/obj/item/weapon/storage/firstaid/advanced,/obj/item/weapon/storage/box/handcuffs,/obj/item/weapon/chainsword,/obj/item/ammo_box/magazine/bpistolmag,/obj/item/ammo_box/magazine/bpistolmag,/obj/item/ammo_box/magazine/bpistolmag,/obj/item/weapon/reagent_containers/pill/bicaridine,/obj/item/weapon/gun/projectile/automatic/bpistol,/turf/simulated/floor/wood,/area/lornfront/bunker/command)
"aG" = (/obj/structure/table/woodentable,/obj/item/weapon/reagent_containers/food/drinks/bottle/amasec,/turf/simulated/floor/wood,/area/lornfront/bunker/command)
"aH" = (/obj/structure/table/woodentable,/obj/item/device/flashlight/lamp,/turf/simulated/floor/wood,/area/lornfront/bunker/command)
"aI" = (/obj/effect/decal/cleanable/dirt,/turf/simulated/floor{dir = 2; icon_state = "floor"; tag = "icon-warningcorner"},/area/lornfront/bunker/command)
"aJ" = (/obj/structure/window/reinforced/tinted{dir = 8; icon_state = "twindow"},/obj/structure/window/reinforced/tinted{dir = 4; icon_state = "twindow"},/obj/structure/window/reinforced/tinted,/obj/structure/window/reinforced/tinted{dir = 1},/obj/structure/grille,/turf/simulated/floor/wood,/area/lornfront/bunker/command)
"aK" = (/turf/simulated/floor/wood,/area/lornfront/bunker/command)
"aL" = (/obj/structure/stool/bed/chair/office/dark{dir = 1},/turf/simulated/floor/wood,/area/lornfront/bunker/command)
"aM" = (/obj/structure/table/woodentable,/obj/item/weapon/paper_bin,/obj/item/weapon/pen,/turf/simulated/floor/wood,/area/lornfront/bunker/command)
"aN" = (/obj/machinery/light{icon_state = "tube1"; dir = 8},/turf/simulated/floor{dir = 2; icon_state = "floor"; tag = "icon-warningcorner"},/area/lornfront/bunker/command)
"aO" = (/obj/structure/stool/bed/chair/office/dark,/turf/simulated/floor{dir = 2; icon_state = "floor"; tag = "icon-warningcorner"},/area/lornfront/bunker/command)
"aP" = (/obj/machinery/door/airlock/command{name = "General quarters"},/turf/simulated/floor/wood,/area/lornfront/bunker/command)
"aQ" = (/obj/machinery/light{dir = 4},/turf/simulated/floor/wood,/area/lornfront/bunker/command)
"aR" = (/obj/machinery/door/airlock/command{name = "Commanding center"},/turf/simulated/floor{dir = 2; icon_state = "floor"; tag = "icon-warningcorner"},/area/lornfront/bunker/command)
"aS" = (/obj/structure/stool/bed/chair/office/dark{dir = 4},/turf/simulated/floor{dir = 2; icon_state = "floor"; tag = "icon-warningcorner"},/area/lornfront/bunker/command)
"aT" = (/obj/structure/table/reinforced,/obj/item/device/radio,/obj/item/device/radio,/obj/item/device/radio,/obj/item/device/radio/voxcaster,/turf/simulated/floor{dir = 2; icon_state = "floor"; tag = "icon-warningcorner"},/area/lornfront/bunker/command)
"aU" = (/obj/structure/table/reinforced,/obj/machinery/computer/imperialvoxcaster/inqaa{desc = "A communication device,it is used mostly for calling reinforcments or assistance from Segmentum Command"; identity = "<FONT COLOR='green'>•412th Company 'Outpost Gamma'</FONT>"},/turf/simulated/floor{dir = 2; icon_state = "floor"; tag = "icon-warningcorner"},/area/lornfront/bunker/command)
"aV" = (/obj/structure/stool/bed/chair/office/dark{dir = 8},/turf/simulated/floor{dir = 2; icon_state = "floor"; tag = "icon-warningcorner"},/area/lornfront/bunker/command)
"aW" = (/obj/structure/stool/bed,/turf/simulated/floor/wood,/area/lornfront/bunker/command)
"aX" = (/obj/structure/stool/bed/chair/office/dark{dir = 4},/obj/effect/decal/cleanable/dirt,/turf/simulated/floor{dir = 2; icon_state = "floor"; tag = "icon-warningcorner"},/area/lornfront/bunker/command)
"aY" = (/obj/structure/table/reinforced,/obj/item/weapon/pen,/obj/item/weapon/paper_bin,/turf/simulated/floor{dir = 2; icon_state = "floor"; tag = "icon-warningcorner"},/area/lornfront/bunker/command)
"aZ" = (/obj/structure/table/reinforced,/turf/simulated/floor{dir = 2; icon_state = "floor"; tag = "icon-warningcorner"},/area/lornfront/bunker/command)
"ba" = (/obj/structure/sign/poster{icon_state = "poster1"},/turf/simulated/wall/polar2,/area/lornfront/bunker/command)
"bb" = (/obj/structure/sign/poster{icon_state = "poster2"},/turf/simulated/wall/polar2,/area/lornfront/bunker/command)
"bc" = (/obj/machinery/light{icon_state = "tube1"; dir = 8},/obj/effect/decal/cleanable/dirt,/turf/simulated/floor{dir = 2; icon_state = "floor"; tag = "icon-warningcorner"},/area/lornfront/bunker/command)
"bd" = (/obj/structure/stool/bed/chair/office/dark{dir = 1},/turf/simulated/floor{dir = 2; icon_state = "floor"; tag = "icon-warningcorner"},/area/lornfront/bunker/command)
"be" = (/obj/machinery/door/airlock/command{name = "Commissar Quarters"},/turf/simulated/floor/wood,/area/lornfront/bunker/command)
"bf" = (/obj/structure/stool/bed/chair/office/dark,/turf/simulated/floor/wood,/area/lornfront/bunker/command)
"bg" = (/obj/structure/sign/poster{desc = "An Imperially sanctioned poster cautioning against mutants."; icon_state = "poster4_legit"; name = "Report Mutants"},/turf/simulated/wall/polar2,/area/lornfront/bunker/command)
"bh" = (/obj/structure/table/reinforced,/obj/item/weapon/storage/bible/booze,/turf/simulated/floor{dir = 2; icon_state = "floor"; tag = "icon-warningcorner"},/area/lornfront/bunker/command)
"bi" = (/obj/machinery/light,/turf/simulated/floor{dir = 2; icon_state = "floor"; tag = "icon-warningcorner"},/area/lornfront/bunker/command)
"bj" = (/obj/structure/filingcabinet/chestdrawer,/turf/simulated/floor{dir = 2; icon_state = "floor"; tag = "icon-warningcorner"},/area/lornfront/bunker/command)
"bk" = (/obj/structure/closet{desc = "You can keep the beer until the guardsman revolt and kill you,then entering and gathering it,or share it,who the fuck knows."; icon_closed = "cabinet_closed"; icon_opened = "cabinet_open"; icon_state = "cabinet_closed"; name = "Commissar supplies"},/obj/item/weapon/storage/fancy/sixpack_beer,/obj/item/weapon/storage/fancy/sixpack_rootbeer,/obj/item/weapon/storage/fancy/donut_box,/obj/item/weapon/storage/firstaid/advanced,/obj/item/weapon/storage/box/handcuffs,/obj/item/weapon/storage/box/handcuffs,/obj/item/clothing/head/commissarcap,/obj/item/weapon/chainsword,/obj/item/weapon/torture,/obj/item/ammo_box/magazine/bpistolmag,/obj/item/ammo_box/magazine/bpistolmag,/obj/item/ammo_box/magazine/bpistolmag,/obj/item/weapon/gun/projectile/automatic/bpistol,/obj/item/weapon/reagent_containers/pill/bicaridine,/obj/item/weapon/book/manual/detective,/obj/item/weapon/book/manual/security_space_law,/obj/item/weapon/book/manual/security_space_law,/turf/simulated/floor/wood,/area/lornfront/bunker/command)

(1,1,1) = {"
aaaaaaaaaaaaaaaaaaaaaaaaaaaaaaaaaaaaaaaaaaaaaaaaaaaaaaaaaaaa
aaaaaaaaaaaaaaaaaaaaaaaaaaaaaaaaaaaaaaaaaaaaaaaaaaaaaaaaaaaa
aaaaaaaaaaaaaaaaaaaaaaaaaaaaaaaaaaaaaaaaaaaaaaaaaaaaaaaaaaaa
aaaaaaaaaaaaaaaaaaaaaaaaaaaaaaaaaaaaaaaaaaaaaaaaaaaaaaaaaaaa
aaaaaaaaaaaaaaaaaaaaaaaaaaaaaaaaaaaaaaaaaaaaaaaaaaaaaaaaaaaa
aaaaaaaaaaaaaaaaaaaaaaaaaaaaaaaaaaaaaaaaaaaaaaaaaaaaaaaaaaaa
aaaaaaaaaaaaaaaaaaaaaaaaaaaaaaaaaaaaaaaaaaaaaaaaaaaaaaaaaaaa
aaaaaaaaaaaaaaaaaaaaaaaaaaaaaaaaaaaaaaaaaaaaaaaaaaaaaaaaaaaa
aaaaaaaaaaaaaaaaaaaaaaaaaaaaaaaaaaaaaaaaaaaaaaaaaaaaaaaaaaaa
aaaaaaaaaaaaaaaaaaaaaaaaaaaaaaaaaaaaaaaaaaaaaaaaaaaaaaaaaaaa
aaaaaaaaaaaaaaaaaaaaaaaaaaaaaaaaaaaaaaaaaaaaaaaaaaaaaaaaaaaa
aaaaaaaaaaaaaaaaaaaaaaaaaaaaaaaaaaaaaaaaaaaaaaaaaaaaaaaaaaaa
aaaaaaaaaaaaaaaaaaaaaaaaaaaaaaaaaaaaaaaaaaaaaaaaaaaaaaaaaaaa
aaaaaaaaaaaaaaaaaaaaaaaaaaaaaaaaaaaaaaaaaaaaaaaaaaaaaaaaaaaa
aaaaaaaaaaaaaaaaaaaaaaaaaaaaaaaaaaaaaaaaaaaaaaaaaaaaaaaaaaaa
aaaaaaaaaaaaaaaaaaaaaaaaaaaaaaaaaaaaaaaaaaaaaaaaaaaaaaaaaaaa
aaaaaaaaaaaaaaaaaaaaaaaaaaaaaaaaaaaaaaaaaaaaaaaaaaaaaaaaaaaa
aaaaaaaaaaaaaaaaaaaaaaaaaaaaaaaaaaaaaaaaaaaaaaaaaaaaaaaaaaaa
aaaaaaaaaaaaaaaaaaaaaaaaaaaaaaaaaaaaaaaaaaaaaaaaaaaaaaaaaaaa
aaaaaaaaaaaaaaaaaaaaaaaaaaaaaaaaaaaaaaaaaaaaaaaaaaaaaaaaaaaa
aaaaaaaaaaaaaaaaaaaaaaaaaaaaaaaaaaaaaaaaaaaaaaaaaaaaaaaaaaaa
aaaaaaaaaaaaaaaaaaaaaaaaaaaaaaaaaaaaaaaaaaaaaaaaaaaaaaaaaaaa
aaaaaaaaaaaaaaaaaaaaaaaaaaaaaaaaaaaaaaaaaaaaaaaaaaaaaaaaaaaa
aaaaaaaaaaaaaaaaaaaaaaaaaaaaaaaaaaaaaaaaaaaaaaaaaaaaaaaaaaaa
aaaaaaaaaaaaaaaaaaaaaaaaaaaaaaaaaaaaaaaaaaaaaaaaaaaaaaaaaaaa
aaaaaaaaaaaaaaaaaaaaaaaaaaaaaaaaaaaaaaaaaaaaaaaaaaaaaaaaaaaa
aaaaaaaaaaaaaaaaaaaaaaaaaaaaaaaaaaaaaaaaaaaaaaaaaaaaaaaaaaaa
aaaaaaaaaaaaaaaaaaaaaaaaaaaaaaaaaaaaaaaaaaaaaaaaaaaaaaaaaaaa
aaaaaaaaaaaaaaaaaaaaaaaaaaaaaaaaaaaaaaaaaaaaaaaaaaaaaaaaaaaa
aaaaaaaaaaaaaaaaaaaaaaaaaaaaaaaaaaaaaaaaaaaaaaaaaaaaaaaaaaaa
aaaaaaaaaaaaaaaaaaaaaaaaaaaaaaaaaaaaaaaaaaaaaaaaaaaaaaaaaaaa
aaaaaaaaaaaaaaaaaaaaaaaaaaaaaaaaaaaaaaaaaaaaaaaaaaaaaaaaaaaa
aaaaaaaaaaaaaaaaaaaaaaaaaaaaaaaaaaaaaaaaaaaaaaaaaaaaaaaaaaaa
aaaaaaaaaaaaaaaaaaaaaaaaaaaaaaaaaaaaaaaaaaaaaaaaaaaaaaaaaaaa
aaaaaaaaaaaaaaaaaaaaaaaaaaaaaaaaaaaaaaaaaaaaaaaaaaaaaaaaaaaa
abababababababababababababababababababababababababababababab
abababababababababababababababababababababababababababababab
abababababababababababababababababababababababababababababab
abababababababababababababababababababababababababababababab
abababababababababababababababababababababababababababababab
abababababababababababababababababababababababababababababab
abababababababababababababababababababababababababababababab
abababababababababababababababababababababababababababababab
abababababababababababababababababababababababababababababab
abababababababababababababababababababababababababababababab
abababababababababababababababababababababababababababababab
abababababababababababababababababababababababababababababab
abababababababababababababababababababababababababababababab
abababababababababababababababababababababababababababababab
abababababababababababababababababababababababababababababab
abababababababababababababababababababababababababababababab
abababababababababababababababababababababababababababababab
abababababababababababababababababababababababababababababab
abababababababababababababababababababababababababababababab
abababababababababababababababababababababababababababababab
abababababababababababababababababababababababababababababab
abababababababababababababababababababababababababababababab
abababababababababababababababababababababababababababababab
abababababababababababababababababababababababababababababab
abababababababababababababababababababababababababababababab
abababababababababababababababababababababababababababababab
abababababababababababababababababababababababababababababab
abababababababababababababababababababababababababababababab
abababababababababababababababababababababababababababababab
abababababababababababababababababababababababababababababab
abababababababababababababababababababababababababababababab
abababababababababababababababababababababababababababababab
abababababababababababababababababababababababababababababab
abababababababababababababababababababababababababababababab
abababababababababababababababababababababababababababababab
abababababababababababababababababababababababababababababab
abababababababababababababababababababababababababababababab
abababababababababababababababababababababababababababababab
abababababababababababababababababababababababababababababab
abababababababababababababababababababababababababababababab
abababababababababababababababababababababababababababababab
abababababababababababababababababababababababababababababab
abababababababababababababababababababababababababababababab
abababababababababababababababababababababababababababababab
abababababababababababababababababababababababababababababab
abababababababababababababababababababababababababababababab
abababababababababababababababababababababababababababababab
abababababababababababababababababababababababababababababab
abababababababababababababababababababababababababababababab
abababababababababababababababababababababababababababababab
abababababababababababababababababababababababababababababab
abababababababababababababababababababababababababababababab
abababababababababababababababababababababababababababababab
abababababababababababababababababababababababababababababab
abababababababababababababababababababababababababababababab
acacacacacacacacacacacacacacacacacacacacacacacacacacacacacac
acacacacacacacacacacacacacacacacacacacacacacacacacacacacacac
acacacacacacacacacacacacacacacacacacacacacacacacacacacacacac
acacacacacacacacacacacacacacacacacacacacacacacacacacacacacac
acacacacacacacacacacacacacacacacacacacacacacacacacacacacacac
acacacacacacacacacacacacacacacacacacacacacacacacacacacacacac
acacacacacacacacacacacacacacacacacacacacacacacacacacacacacac
acacacacacacacacacacacacacacacacacacacacacacacacacacacacacac
acacacacacacacacacacacacacacacacacacacacacacacacacacacacacac
acacacacacacacacacacacacacacacacacacacacacacacacacacacacacac
acacacacacacacacacacacacacacacacacacacacacacacacacacacacacac
acacacacacacacacacacacacacacacacacacacacacacacacacacacacacac
acacacacacacacacacacacacacacacacacacacacacacacacacacacacacac
acacacacacacacacacacacacacacacacacacacacacacacacacacacacacac
acacacacacacacacacacacacacacacacacacacacacacacacacacacacacac
acacacacacacacacacacacacacacacacacacacacacacacacacacacacacac
acacacacacacacacacacacacacacacacacacacacacacacacacacacacacac
acacacacacacacacacacacacacacacacacacacacacacacacacacacacacac
acacacacacacacacacacacacacacacacacacacacacacacacacacacacacac
acacacacacacacacacacacacacacacacacacacacacacacacacacacacacac
acacacacacacacacacacacacacacacacacacacacacacacacacacacacacac
acacacacacacacacacacacacacacacacacacacacacacacacacacacacacac
acacacacacacacacacacacacacacacacacacacacacacacacacacacacacac
acacacacacacacacacacacacacacacacacacacacacacacacacacacacacac
acacacacacacacacacacacacacacacacacacacacacacacacacacacacacac
acacacacacacacacacacacacacacacacacacacacacacacacacacacacacac
acacacacacacacacacacacacacacacacacacacacacacacacacacacacacac
acacacacacacacacacacacacacacacacacacacacacacacacacacacacacac
acacacacacacacacacacacacacacacacacacacacacacacacacacacacacac
acacacacacacacacacacacacacacacacacacacacacacacacacacacacacac
acacacacacacacacacacacacacacacacacacacacacacacacacacacacacac
acacacacacacacacacacacacacacacacacacacacacacacacacacacacacac
acacacacacacacacacacacacacacacacacacacacacacacacacacacacacac
acacacacacacacacacacacacacacacacacacacacacacacacacacacacacac
acacacacacacacacacacacacacacacacacacacacacacacacacacacacacac
acacacacacacacacacacacacacacacacacacacacacacacacacacacacacac
acacacacacacacacacacacacacacacacacacacacacacacacacacacacacac
acacacacacacacacacacacacacacacacacacacacacacacacacacacacacac
acacacacacacacacacacacacacacacacacacacacacacacacacacacacacac
acacacacacacacacacacacacacacacacacacacacacacacacacacacacacac
acacacacacacacacacacacacacacacacacacacacacacacacacacacacacac
acacacacacacacacacacacacacacacacacacacacacacacacacacacacacac
acacacacacacacacacacacacacacacacacacacacacacacacacacacacacac
acacacacacacacacacacacacacacacacacacacacacacacacacacacacacac
acacacacacacacacacacacacacacacacacacacacacacacacacacacacacac
acacacacacacacacacacacacacacacacacacacacacacacacacacacacacac
acacacacacacacacacacacacacacacacacacacacacacacacacacacacacac
acacacacacacacacacacacacacacacacacacacacacacacacacacacacacac
acacacacacacacacacacacacacacacacacacacacacacacacacacacacacac
acacacacacacacacacacacacacacacacacacacacacacacacacacacacacac
acacacacacacacacacacacacacacacacacacacacacacacacacacacacacac
acacacacacacacacacacacacacacacacacacacacacacacacacacacacacac
acacacacacacacacacacacacacacacacacacacacacacacacacacacacacac
acacacacacacacacacacacacacacacacacacacacacacacacacacacacacac
acacacacacacacacacacacacacacacacacacacacacacacacacacacacacac
adadadadadadadadadadadadadadadadadadadadadadadadadadadadadad
adadadadadadadadadadadadadadadadadadadadadadadadadadadadadad
adadadadadadadadadadadadadadadadadadadadadadadadadadadadadad
adadadadadadadadadadadadadadadadadadadadadadadadadadadadadad
adadadadadadadadadadadadadadadadadadadadadadadadadadadadadad
adadadadadadadadadadadadadadadadadadadadadadadadadadadadadad
adadadadadadadadadadadadadadadadadadadadadadadadadadadadadad
adadadadadadadadadadadadadadadadadadadadadadadadadadadadadad
adadadadadadadadadadadadadadadadadadadadadadadadadadadadadad
adadadadadadadadadadadadadadadadadadadadadadadadadadadadadad
adadadadadadadadadadadadadadadadadadadadadadadadadadadadadad
adadadadadadadadadadadadadadadadadadadadadadadadadadadadadad
adadadadadadadadadadadadadadadadadadadadadadadadadadadadadad
adadadadadadadadadadadadadadadadadadadadadadadadadadadadadad
adadadadadadadadadadadadadadadadadadadadadadadadadadadadadad
adadadadadadadadadadadadadadadadadadadadadadadadadadadadadad
adadadadadadadadadadadadadadadadadadadadadadadadadadadadadad
adadadadadadadadadadadadadadadadadadadadadadadadadadadadadad
adadadadadadadadadadadadadadadadadadadadadadadadadadadadadad
adadadadadadadadadadadadadadadadadadadadadadadadadadadadadad
adadadadadadadadadadadadadadadadadadadadadadadadadadadadadad
adadadadadadadadadadadadadadadadadadadadadadadadadadadadadad
adadadadadadadadadadadadadadadadadadadadadadadadadadadadadad
adadadadadadadadadadadadadadadadadadadadadadadadadadadadadad
adadadadadadadadadadadadadadadadadadadadadadadadadadadadadad
adadadadadadadadadadadadadadadadadadadadadadadadadadadadadad
adadadadadadadadadadadadadadadadadadadadadadadadadadadadadad
adadadadadadadadadadadadadadadadadadadadadadadadadadadadadad
adadadadadadadadadadadadadadadadadadadadadadadadadadadadadad
adadadadadadadadadadadadadadadadadadadadadadadadadadadadadad
adadadadadadadadadadadadadadadadadadadadadadadadadadadadadad
adadadadadadadadadadadadadadadadadadadadadadadadadadadadadad
adadadadadadadadadadadadadadadadadadadadadadadadadadadadadad
adadadadadadadadadadadadadadadadadadadadadadadadadadadadadad
adadadadadadadadadadadadadadadadadadadadadadadadadadadadadad
adadadadadadadadadadadadadadadadadadadadadadadadadadadadadad
adadadadadadadadadadadadadadadadadadadadadadadadadadadadadad
adadadadadadadadadadadadadadadadadadadadadadadadadadadadadad
adadadadadadadadadadadadadadadadadadadadadadadadadadadadadad
adadadadadadadadadadadadadadadadadadadadadadadadadadadadadad
adadadadadadadadadadadadadadadadadadadadadadadadadadadadadad
adadadadadadadadadadadadadadadadadadadadadadadadadadadadadad
adadadadadadadadadadadadadadadadadadadadadadadadadadadadadad
adadadadadadadadadadadadadadadadadadadadadadadadadadadadadad
adadadadadadadadadadadadadadadadadadadadadadadadadadadadadad
adadadadadadadadadadadadadadadadadadadadadadadadadadadadadad
adadadadadadadadadadadadadadadadadadadadadadadadadadadadadad
adadadadadadadadadadadadadadadadadadadadadadadadadadadadadad
adadadadadadadadadadadadadadadadadadadadadadadadadadadadadad
adadadadadadadadadadadadadadadadadadadadadadadadadadadadadad
adadadadadadadadadadadadadadadadadadadadadadadadadadadadadad
adadadadadadadadadadadadadadadadadadadadadadadadadadadadadad
adadadadadadadadadadadadadadadadadadadadadadadadadadadadadad
adadadadadadadadadadadadadadadadadadadadadadadadadadadadadad
adadadadadadadadadadadadadadadadadadadadadadadadadadadadadad
aeaeaeaeaeaeaeaeaeaeaeaeaeaeaeaeaeaeaeaeaeaeaeaeaeaeaeaeaeae
aeaeaeaeaeaeaeaeaeafafaeaeaeaeaeaeaeaeafafaeaeaeaeaeaeaeaeae
aeaeaeaeahahahahahahahafafafafafafafafahahahahahahahaeaeaeae
aeaeaeahahahahahahahahahahahahahahahahahahahahahahahahaeaeae
aeaeaeahahahagagagahahahahahahahahahahahahagagagahahahaeaeae
aeaeaeahahaiajajajaiaiaiaiaiaiaiaiaiaiaiaiajajajaiahahaeaeae
aeaeaeahahaiajajajajajajajajajajajajajajajajajajaiahahaeaeae
aeaeaeahahaiajajajajajajajajajajajajajajajajajajaiahahaeaeae
aeaeaeahahakajajajajajajajajajajajajajajajajajajakahahaeaeae
aeaeaeahahaiajajajajajajajajajajajajajajajajajajaiahahaeaeae
aeaeaeahahaiaiaiaiaiaiaiaiaiaiaiaiaiaiaiaiaiaiaiaiahahaeaeae
aeaeaeahahahahahahahahahahahahahahahahahahahahahahahahaeaeae
aeaeaeahahahahahahahahahahahahahahahahahahahahahahahahaeaeae
aeaeaeahahalalalalalalalalalalalalalalalalalalalalahahaeaeae
aeaeaeahahalamamanaoaoanapapanaqaqananarararararalahahaeaeae
aeaeaeahahalananananananananananananananananananalahahaeaeae
aeaeaeahahasanananatatanauauanavawanananananananasahahaeaeae
aeaeaeahahasananananananananananananananananananasahahaeaeae
aeaeaeahahalanananatatanauauanavawananaxayayayayalahahaeaeae
aeaeaeahahalananananananananananananananananananalahahaeaeae
aeaeaeahahalamamanaoaoanapapanaqaqananaxayayayayalahahaeaeae
aeaeaeahahalalalalalalalalalalalalalalalalalalalalahahaeaeae
aeaeaeahahahahahahahahahahahahahahahahahahahahahahahahaeaeae
aeaeaeahahahahahahahahahahahahahahahahahahahahahahahahaeaeae
aeaeaeahahaeaeaeaeaeaeaeaeaeaeaeaeaeaeaeaeaeaeaeaeaeaeaeaeae
aeaeaeahahaeaeaeaeaeaeaeaeaeaeaeaeaeaeaeaeaeaeaeaeaeaeaeaeae
aeaeaeahahaeaeaeaeaeaeaeaeaeaeaeaeaeaeaeaeaeaeaeaeaeaeaeaeae
aeaeaeahahaeaeaeaeaeaeaeaeaeaeaeaeaeaeaeaeaeaeaeaeaeaeaeaeae
aeaeaeahahaeaeaeaeaeaeaeaeaeaeaeaeaeaeaeaeaeaeaeaeaeaeaeaeae
aeaeaeahahaeaeaeaeaeaeaeaeaeaeaeaeaeaeaeaeaeaeaeaeaeaeaeaeae
aeaeaeahahaeaeaeaeaeaeaeaeaeaeaeaeaeaeaeaeaeaeaeaeaeaeaeaeae
aeaeaeahahaeaeaeaeaeaeaeaeaeaeaeaeaeaeaeaeaeaeaeaeaeaeaeaeae
aeaeaeahahaeaeaeaeaeaeaeaeaeaeaeaeaeaeaeaeaeaeaeaeaeaeaeaeae
aeaeaeahahaeaeaeaeaeaeaeaeaeaeaeaeaeaeaeaeaeaeaeaeaeaeaeaeae
aeaeaeahahaeaeaeaeaeaeaeaeaeaeaeaeaeaeaeaeaeaeaeaeaeaeaeaeae
aeaeaeahahaeaeaeaeaeaeaeaeaeaeaeaeaeaeaeaeaeaeaeaeaeaeaeaeae
aeaeaeahahaeaeaeaeaeaeaeaeaeaeaeaeaeaeaeaeaeaeaeaeaeaeaeaeae
aeaeaeahahaeaeaeaeaeaeaeaeaeaeaeaeaeaeaeaeaeaeaeaeaeaeaeaeae
aeaeaeahahaeaeaeaeaeaeaeaeaeaeaeaeaeaeaeaeaeaeaeaeaeaeaeaeae
aeaeaeahahaeaeaeaeaeaeaeaeaeaeaeaeaeaeaeaeaeaeaeaeaeaeaeaeae
aeaeaeahahaeaeaeaeaeaeaeaeaeaeaeaeaeaeaeaeaeaeaeaeaeaeaeaeae
aeaeaeahahaeaeaeaeaeaeaeaeaeaeazazazazazazazazazazazaeaeaeae
aeaeaeahahaeaeaeaeaeaeaeaeaeazazaAaBaCaDaEazaFaGaHazazaeaeae
aeaeaeahahaeaeaeaeaeaeaeaeaeazaIaDaDaIaDaDaJaKaLaMazazaeaeae
aeaeaeahahaeaeaeaeaeaeaeaeaeazaNaDaOaOaDaDaPaKaKaQazazaeaeae
ahahahahahahahahahahahahahahaRaDaSaTaUaVaIazaKaKaWazazaeaeae
ahahahahahahahahahahahahahahaRaDaXaYaZaVaDazazbabbazazaeaeae
aeaeaeaeaeaeaeaeaeaeaeaeaeaeazbcaDbdbdaDaDaJaKaKaWazazaeaeae
aeaeaeaeaeaeaeaeaeaeaeaeaeaeazaIaDaDaDaDaDbeaKbfaQazazaeaeae
aeaeaeaeaeaeaeaeaeaeaeaeaeaeazbgaZbhbiaIbjazaGaMbkazazaeaeae
aeaeaeaeaeaeaeaeaeaeaeaeaeaeaeazazazazazazazazazazazaeaeaeae
aeaeaeaeaeaeaeaeaeaeaeaeaeaeaeaeaeaeaeaeaeaeaeaeaeaeaeaeaeae
aeaeaeaeaeaeaeaeaeaeaeaeaeaeaeaeaeaeaeaeaeaeaeaeaeaeaeaeaeae
aeaeaeaeaeaeaeaeaeaeaeaeaeaeaeaeaeaeaeaeaeaeaeaeaeaeaeaeaeae
aeaeaeaeaeaeaeaeaeaeaeaeaeaeaeaeaeaeaeaeaeaeaeaeaeaeaeaeaeae
"}
